
NO hello.xpm 
WE hello1.xpm

EA hello2.xpm
SO hello3.xpm

F 1, 255,   20
C 5, 130,   50

11111111111111111111111111
10000000000000000000000001
10011W01000000110000000001
10000000100000000000000001
10000001 10000000000000001
11111111111111111111111111  
